Baby ID ,>Average,<Average,>Average+2STD,<Average-2STD,>Average,<Average,>Average+2STD,<Average-2STD,Control,Case,
15,33,10,3,1,29,13,2,1,4,3,7
70,5,37,0,13,6,37,0,13,13,13,26
82,16,25,2,2,17,23,0,0,4,0,4
97,26,15,7,4,26,14,5,2,11,7,18
101,20,21,4,0,18,22,0,1,4,1,5
125,19,22,2,1,19,21,0,2,3,2,5
128,16,25,1,1,12,28,0,0,2,0,2
131,25,16,1,2,21,19,0,0,3,0,3
138,10,32,0,12,12,30,0,13,12,13,25
142,17,24,4,1,17,23,2,0,5,2,7
